0999009009000999
9009990900900090
0090099009999099
9909000990000990
9090009009000000
0000000909990009
9099009000999099
0900000999909900
9090999000000009
9990090990009990
0000909090999009
9909009900000090
0099909900009009
9000099900990999
0990099090909000
0000090900999990