99009909009009009999009900990990
09999009009990099900900990990090
90090090990990099990009009909909
99000990090099009999099009909099
00990999099090090099090999009009
90990099090099099909900090990009
09990900999000999000099009009909
90090900999099099000099099009099
00990900900900999900900900099099
09909900900999900999900900099099
09909000999099099009990090990009
90009099009099099009990090990900
90900099090099099099090090990900
09900999090090990999900999090090
09900090990090990999900999099000
90990090900990990999009909990090