9090009990000999
0090900009909009
9099090090009000
9900999900900090
0990999090900999
0099009909900000
9909900999090090
0090099990099900
9909900099009909
0909900999900990
0099090909900900
9900999909000990
0999909909900000
9009909900000000
0090099990099900
0090099990099900