9900090000909900
0000900900090000
0909900900009990
0090099090009900
0990090090009909
0009900090900900
0090900990090990
0099009900900099
9000090099900900
0909900090090990
9909000900090990
0090990000990090
9000099000900900
0009009090009909
0009009900009900
9000900909900090